blue: 0,F,R,E,D
+++++++++++
+0   f + D+
+    r + E+
+    e   R+
+    d + F+
+++++++++++

