blue: 0,F,R,E,D
++++++++++++
+0   D d +a+
+    A   +b+
+         c+
+C     B+  +
++++++++++++

