blue: 0,F,R,E,D
++++++++++++
+0D  d +  f+
+   E  +  r+
+   R     e+
+   F  +   +
++++++++++++

