red: 0,A
cyan: 1,B
++++++++++
+      ++
+0A    +++
+1B    ba+
+      +++
++++++++++