red: 0,A
green: 1,C
++++++++++++++++++
+0    C C C A A A+
+c               +
+                +
+c+ a  a  a   1  +
+c++++++++++++++++
+++
