blue: 0,A,B
++++++++++++
+0  A   Bba+
++++   +++++
+++++ ++++++
++++++++++++

