blue: 0,J,A,K,E
+++++++++
+ JAKE  +
+       +
+    0  +
+j+++++++
+a+
+k+
+e+
+++