++++++++++++++++
+0 A        B 2+
++++  N L   ++++
+1   JE        +
+ F     G    + +
+H   D    K I+C+
+      O     +3+
+         M  +++
+              +
+m+l+h+i+      +
+k+j+o+n+      +
+d+f+g+e+      +
++++++++++++++++
